000000000000000000000
000000000000000000000
000000000000000000000
000000000000000000000
000000000000000000000
000000000000000000000
000000000000000000000
001111111111100005100
001111111111110011000
001911117771111111000
001BZ1517271111114000
001A11117771111111000
001111111111110011000
001111111111100005100
000000000000000000000
000000000000000000000
000000000000000000000
000000000000000000000
000000000000000000000
000000000000000000000
000000000000000000000