000000000000000000000
000000000000000000000
000000000000000000000
000000000000000000000
000000111111111000000
000000111111111000000
00000011Z1BA511000000
00000011GDC5111000000
00000011FE51111000000
000000111111111000000
000000111777111000000
000000111737111000000
000000111797111000000
000000111777111000000
000000111111111000000
000000000000000000000
000000000040000000000
000000000000000000000
000000000000000000000
000000000000000000000
000000000000000000000