000000000000000000000
000000000000000000000
000000000000000000000
000000000000000000000
000111111141111111000
000111131151311111000
0001111ABZ11111111000
000777777777777777000
000015111111111510000
000113111212111311000
000100001111100001000
000100001111100001000
000100001191100001000
000100001101100001000
000100001000100001000
000111001101101101000
000116001621106111000
000000000000000000000
000000000000000000000
000000000000000000000
000000000000000000000