000000000000000000000
000000000000000000000
000000000000000000000
000000000000000000000
000014444444444410000
000004261111412400000
000004611161110400000
000000441111144000000
000000044414440000000
000000001414100000000
000000004151400090000
000000001515100000000
000000005151500000000
000000451515154000000
000004535131535400000
000004151ABCZ51400000
000011111111111110000
000000000000000000000
000000000000000000000
000000000000000000000
000000000000000000000