000000000000000000000
000000000060000000000
000000000000000000000
000160000111114400000
000100000131319400000
001610000112111100000
001100000111111100000
000000000000011100000
000000000000011100000
000000000050001100000
000000000005000000000
000011110000000000000
000011111000000000000
000001111000000000000
001101131111100000000
006101111111100000000
0011011351311ZC000000
0000011114111AB000000
000000000000000000000
000000000006000000000
000000000000000000000