000000000000000000000
000000000000000000000
000000044440000440000
006111111177377140000
000001454440000100000
000001414000000100000
000001414000000100000
000111554000000100000
000131111000000100000
000111BA1111111100000
000131CDZ100000000000
000111111600000000000
000000000000000000000
000000000000001110000
000000000000001910000
000000000000001110000
000000000000001210000
000000000000004440000
000000000000000000000
000000000000000000000
000000000000000000000