000000000000000000000
000000000000000000000
000000000000000000000
000000000000000000000
000000000000000000000
000000000000000000000
000441144000000000000
000421124000111110000
000411111000111140000
000441111000113140000
00044211100011AB40000
000441111000119Z40000
000411111000111140000
000021124000111100000
000041144000000000000
000000000000000000000
000000000000000000000
000000000000000000000
000000000000000000000
000000000000000000000
000000000000000000000