000000000000000000000
000000000000000000000
000000000000000000000
000000000000000000000
000000000000000000000
000000000000000000000
000000000000000444440
001111111000000411140
001111911000000413140
001111111000004411140
001111111000000111140
001611111002001111140
001611111002001ZDC140
0016111110020011AB140
001111111000001111140
001111111000004444440
000000000000000000000
000000000000000000000
000000000000000000000
000000000000000000000
000000000000000000000