000000000000000000000
000000000000000000000
000000000000000000000
000000000000000000000
000011100000000000000
000444440000000011100
000411140000000111100
000412144000001111600
000411111000011191600
000421144000001111600
00041A240000000111100
00041Z140000000011100
000413140000000000000
000411140000000000000
000411140000000000000
000444440000000000000
000011100000000000000
000000000000000000000
000000000000000000000
000000000000000000000
000000000000000000000