000000000000000000000
000000000000000000000
000000000000000000000
000000000000000000000
000000044444440000000
000000041595540000000
000000041151140000000
000000041515140000000
001111145151541111000
001441144414441441000
001411151114111141000
001111144444111111000
001111111111113111000
001111CB1Z11111111000
001411DA1I11111141000
001441EFGH11111441000
001111111111111111000
000000000000000000000
000000000000000000000
000000000000000000000
000000000000000000000